L0000000000000R
L0000000000000R
L0000000000000R
L0000000000000R
L0000000000000R
L0000000000000R
L0000000000000R
L0000000000000R
LPPPPP000PPPPPR
L0000000000000R
L0000000000000R
LPPP0000000PPPR
L0000000000000R
L0000PPPPP0000R
L0000000000000R
L0000000000000R
L000000000PPPPR
L0000000000000R
L0000000000000R
LPPPP000000000R
L0000000000000R
L0000000000000R
L000000000PP00R
L0000000000000R
L0000000000000R
L0000PP0000000R
L0000000000000R
L0000000000000R
LPP00000000000R
L0000000000000R
L0000000000000R
L000000000PPPPR
L0000000000000R
L0000000000000R
L0000PPPPP0000R
L0000000000000R
L0000000000000R
LPPPP000000000R
L0000000000000R
L0000000000000R
L0000PP0000PPPR
L0000000000000R
L0000000000000R
LPPP0000000000R
L0000000000000R
L000000000PPPPR
LPP00000000000R
L0000000000000R
L0000000000000R
L00000000000PPR
L0000000000000R
LPPP0000000000R
L0000000000000R
L0000000000000R
L000000000PPPPR
L0000000000000R
L0000000000000R
LPPP0000000000R
L0000000000000R
L0000000000000R
LPPPP000000000R
L0000000000000R
L0000000000000R
L0000PPPPP0000R
L0000000000000R
L0000000000000R
LPPPP00000PPPPR
L0000000000000R
L0000000000000R
FFFFFFFFFFFFFFF